-250 -100 -214 -194 -137 -263 -66 -210 -26 -255 39 -213 72 -152 152 -152 236 -115 261 -21 228 19 272 102 263 197 200 262 113 241 79 262 30 259 -44 223 -137 232 -202 261 -232 152 -250 100 -400 100 -400 400 400 400 400 -400 -400 -400 -400 -100
0 4
250 100 100 243 0 200 -21 148 -69 228 -183 257 -310 185 -400 190 -400 400 400 400 400 100
0 3
250 -100 200 -200 179 -291 200 -400 400 -400 400 -100
0 3
-48 -345 -92 -263 -181 -219 -247 -116 -382 -96 -400 -400
0 3
350 190 280 227 184 266 118 251 -16 227 -69 227 -153 248 -200 200 -257 116 -307 89 -296 26 -233 -45 -267 -114 -200 -200 -220 -400 -400 -400 -400 400 400 400
0 2
87 -336 131 -209 224 -106 354 -66 400 -400
0 2
-350 178 -235 240 -119 273 -84 145 -19 278 99 235 186 262 280 186 302 91 222 91 178 29 272 -24 283 -162 202 -246 29 -227 -54 -270 -320 -224 -400 -400 400 -400 400 400 -400 400
1 4
-320 320 -100 320 -100 250 -178 277 -215 138 -280 200 -297 178 -320 97
1 1
100 320 100 250 177 256 203 175 239 196 250 100 320 100 320 320
1 1
320 -100 320 -320 -57 -320 20 -223 83 -241 139 -164 201 -179 250 -100
1 1
-320 -130 -278 -179 -237 -261 -320 -320
1 1
-180 150 -100 150 -59 179 21 138 0 57 -101 41 -119 -21 -141 0 -200 37 -220 117
0 1
-100 -320 -100 -250 -199 -220 -222 -162 -279 -141 -299 15 -278 260 -37 317 218 278 259 158 221 20 259 -41 237 -119 180 -183 100 -250 100 -320 320 -320 320 320 -320 320 -320 -320
0 1
320 -320 -10 -320 -81 -101 -59 96 41 120 61 178 100 100 120 -63 200 -63 220 57 157 258 -81 304 -200 200 -241 -44 -264 -320 -320 -320 -320 320 320 320
0 0
-10 320 56 196 238 180 320 97 320 320
1 0
320 -130 302 -158 223 -184 162 -280 140 -320 320 -320
1 0
-100 -320 -143 -203 -219 -180 -279 -43 -280 198 -264 320 -320 320 -320 -320
1 0
-150 100 -70 100 62 79 45 0 -60 -43 -78 -103 -119 0 -201 60
1 0
200 350 210 300 225 236 255 190 381 200 395 352
1 3
-70 300 -76 169 -181 174 -290 59 -272 -202 -162 -282 47 -151 162 -106 285 -127 400 -127 400 -400 -400 -400 -400 400 -70 400
1 3
39 94 -23 59 -41 -41 51 -86 147 -16 109 64
1 3
-184 285 -224 230 -250 100 -400 100 -400 400 -200 400
1 2
-250 -100 -200 -200 -63 -247 102 -287 142 -146 242 -101 263 23 242 174 152 199 107 282 110 400 400 400 400 -400 -400 -400 -400 -100
1 2
-271 310 -320 256 -265 183 -187 161 -48 185 38 256 81 320 400 400 412 245 282 183 146 115 -27 88 -249 137 -456 218 -347 430
2 1
-320 -70 -300 -90 -227 -180 -21 -237 200 -200 429 -91 442 -509 -532 -433
2 1
-100 320 -220 200 -300 28 -238 -10 -200 -200 -36 -160 40 -242 100 -225 120 -162 141 -183 200 -37 281 -37 310 -117 320 -320 -320 -320 -320 320
2 0
140 320 180 221 280 198 320 159 320 320
2 0
-250 100 -164 221 74 306 239 240 270 100 400 100 400 400 -400 400 -400 100
2 3
270 -100 188 -288 -87 -259 -196 -163 -270 -100 -400 -100 -400 -400 400 -400 400 100
2 3
400 400 400 100 250 100 132 205 63 291 -31 296 -95 166 -200 200 -320 147 -400 147 -400 400
2 2
400 -100 250 -100 127 -235 69 -129 -11 -129 -98 -219 -281 -139 -400 -139 -400 -400 400 -400
2 2
